RPPPPPPPPPPPPPPPPPPP
RPPPPPPPPPPPPPPPPPPP
RPPPPPPPPPPPPPPPPPPR
PPPPPPPPPPPPPPGPPPPR
PPPPPPPPPPGGGGPPPPRR
RRRPPPPPPPPGGGPPRRRR
RRPPPPPPPPPPPGGPPPPP
RRPPPPPPPPPPPPPPPPPP
RRRRRPPPPPPPPPPPPPPP
RRRRRPPPPPPPPPPPPPRR